1111111111111
100P0000000C1
1000011110001
100011E000001
1111111111111