1111111111111111111111111111
1E0010C000000000000000000001
1000111000000000000000000001
1P00000000000000C00000000001
1000000000000000000000000001
100C0000000000000000C0000001
1111111111111111111111111111